    ______                ___     __                                                   
   / ____/  ___________ _/ (_)___/ /________ __      __      _________  ____  ____ ___ 
  / __/ | |/_/ ___/ __ `/ / / __  / ___/ __ `/ | /| / /_____/ ___/ __ \/ __ \/ __ `__ \
 / /____>  </ /__/ /_/ / / / /_/ / /  / /_/ /| |/ |/ /_____/ /  / /_/ / /_/ / / / / / /
/_____/_/|_|\___/\__,_/_/_/\__,_/_/   \__,_/ |__/|__/     /_/   \____/\____/_/ /_/ /_/ 
                                                                                       
